29,29,29,29,29,29,29,29,29,29,29,29,29,29,29,29
29,29,29,29,29,29,29,29,29,29,29,29,29,29,29,29
29,29,29,29,29,29,29,29,29,29,29,29,29,29,29,29
29,29,29,29,29,29,29,29,29,29,29,29,29,29,29,29
29,29,29,29,4,4,6,3,2,2,2,3,3,3,3,3
29,29,29,29,3,3,5,3,2,3,2,3,3,3,3,3
29,29,29,29,3,3,5,3,2,3,2,3,3,3,3,3
29,29,29,29,3,3,8,3,2,3,2,3,2,2,2,3
29,29,29,29,3,3,2,3,2,3,2,3,2,3,2,3
29,29,29,29,3,3,2,3,2,3,2,3,2,3,2,3
29,29,29,29,3,3,2,3,2,3,2,3,2,3,2,3
29,29,29,29,3,3,2,2,2,3,2,2,2,3,2,2
