29,29,29,29,29,29,29,29,29,29,29,29,29,29,29,29
29,29,29,29,29,29,29,29,29,29,29,29,29,29,29,29
29,29,29,29,29,29,29,29,29,29,29,29,29,29,29,29
29,29,29,29,29,29,29,29,29,29,29,29,29,29,29,29
29,29,29,29,2,2,2,3,29,29,29,29,29,29,29,29
29,29,29,29,3,3,2,3,29,29,30,30,30,30,33,30
29,29,29,29,3,3,2,3,29,29,30,30,30,30,33,30
29,29,29,29,3,3,2,3,29,29,30,30,30,30,33,30
29,29,29,29,3,3,2,3,29,29,30,30,30,30,33,30
29,29,29,29,29,29,29,29,29,29,30,30,30,30,33,30
29,29,29,29,29,29,29,29,29,29,30,30,30,30,33,30
29,29,29,29,29,29,29,29,29,29,30,30,30,30,33,30
