29,29,29,29,29,29,29,29,29,29,29,29,29,29,29,29
29,29,29,29,29,29,29,29,29,29,29,29,29,29,29,29
29,29,29,29,29,29,29,29,29,29,29,29,29,29,29,29
29,29,29,29,29,29,29,29,29,29,29,29,29,29,29,29
29,29,29,29,3,3,3,1,3,3,3,1,1,1,1,1
29,29,29,29,1,1,3,1,3,1,3,1,1,1,1,1
29,29,29,29,1,1,3,1,3,1,3,1,1,1,1,1
29,29,29,29,1,1,3,1,3,1,3,1,1,3,3,3
29,29,29,29,1,1,3,1,3,1,3,1,1,3,1,3
29,29,29,29,1,1,3,1,3,1,3,1,1,3,1,3
29,29,29,29,1,1,3,1,3,1,3,1,1,3,1,3
29,29,29,29,1,1,3,3,3,1,3,3,3,3,1,3
