10,12,12,12,12,12,12,12,12,12,12,12,11,11,11,11
3,3,3,3,3,3,3,3,3,3,3,3,11,11,11,11
12,12,12,12,12,12,12,12,12,12,12,3,11,11,11,11
12,12,12,12,12,12,12,12,12,12,12,3,11,11,11,11
1,1,1,1,1,1,1,1,2,2,2,5,11,11,11,11
1,1,1,1,1,1,1,1,2,2,2,5,11,11,11,11
1,1,1,1,1,1,1,1,2,2,2,5,11,11,11,11
1,1,1,1,1,1,1,1,2,2,2,5,11,11,11,11
12,12,12,12,2,2,2,2,2,2,2,5,11,11,11,11
3,3,3,3,4,4,4,4,4,4,4,9,11,11,11,11
3,12,12,12,2,2,2,2,2,2,2,2,11,11,11,11
10,12,12,12,2,2,2,2,2,2,2,2,11,11,11,11
